50
30
#######................###########################
........................................##########
.........................................#######..
###############...................................
.#############....................................
........#####..............######.................
.........########...........####..................
......................................#####.......
.......................................###........
..................................................
..............................####################
...................................###############
#####################....................#########
###############.............................######
###...........................................####
############...............................####.##
....######################................##....##
......######...........##.......................##
............######..............................##
..........................####........############
.........................######.......######......
............######.....................###........
............###.........................##........
........######..............#######.....######....
...........................###...###..............
.........................#####...##...............
#######...................################........
###.........####...........####....########.......
#########...############################........##
##################################################

