84
70
##................................................................................##
##................................................................................##
##................................................................................##
##-------*.........+----*.........................................................##
##########.........######.........................................................##
##########.........######.......................+-*..................+--->........##
##..............................................###..................###..........##
##...............................................##..................###..........##
##..................................+-------*....##..................###..........##
##.............+-*..................#########....##..................###..........##
##.............###..................##...........##----*.............###..........##
##.......................+-*........##...........#######.............###..........##
##.......................###........##...........####................###-------*..##
##.......................###........##.............##................###########..##
##.......................###........##.............##................###..........##
##.......................###...+----##.............##................###..........##
##........+-*.........+--###...#######.............##................###..........##
##........###.........######...#######.............##...+------*.....###..........##
##.......................###...#######.............##...########.....###......+---##
##.......................###...#######.............##................###......######
##....+-*..........<->...###...#######.............##................###......######
##....###................###---#######-------------##................###...........X
##.......................############################................###...........X
##.......................###.........................................###...........X
##.............+-*.......###.........................................###...........X
##.............###.......###.........................................###...........X
##.......................###.........................................###...........X
##----*..................###-----------------------------------------###------------
#######..................###########################################################
#######............................#################################################
#######.....................................########################################
#######--------------------*................########################################
############################................########################################
############################..................................................######
############################-----*............................................######
##.......................#########............................................######
##.......................#########.............................................#####
##.......................#########...........................+*................#####
##.......................###.................................##.................####
##.......................###.................................##-*...............####
##.......................###---------------*.............+---####...............####
##...............<--*....###################.............########.................##
##.................##.....................##.............########--*..............##
##.................##.....................##....................####..............##
##.....<------->..........................##*.....................................##
##........................................###.........................+---*.......##
##......................<---*.............###.........................#####.......##
##---------*..............###.........#######--*..................................##
############..............###.........##########................................+-##
##........................###..........................+--*.....................####
##........................###..........................####.....................####
##........................###............................##-*...................####
##........................###............................####.................+-####
##........................###.................................................######
##---*....................###.................................................######
######........+-*.........###.................................................######
######........###.........###....................................+---*.....+--######
..........................###--*.................................#####.....#########
..........................######...........................................#########
..........................######-------*...................................#########
............+*............##############................................+--#########
............##--*.........##############................................############
............#####.........##########.....................+---*..........############
..........+-#####.........##########.....................#####..........############
P.........#######---------##########--------*............#####..........############
----------###################################------------#####----------############
####################################################################################
####################################################################################
####################################################################################
####################################################################################
4
5
65
4
IceSummon
SkyUppercut
IceSummon
DoubleJump
28
50
3
DoubleJump
DoubleJump
GlacialDrift
27
31
4
DoubleJump
GlacialDrift
IceSummon
SkyUppercut
42
8
4
SkyUppercut
GlacialDrift
IceSummon
DoubleJump
map9to12

