150
75
..................................................##.......................................................####.....................................##
..................................................##.......................................................####.....................................##
..................................................##.......................................................####...###...............................##
..................................................##.......................................................####...###...............................##
..................................................##......................####.............................####...###......###......................##
##..######........................................##......................####.............................####...###......###......................##
##..######........................................##........................##.............................####...###...............................##
##......##........................................##...##########...........##.............................####...###...............................##
##......##........................................##...##########...........##...................................................###................##
##......##........................................##...........##...........##...................................................###................##
##......###########.............############...................##...........##...................................................###................##
##......###########.............############...................##...........##..............................................########................##
##...............##.............##.............................##...........##..............................................########................##
##...............##.............##............##...............##...........##.............................................................###......##
##....#############.............##............##...............##...........##.............######################..........................###......##
##...............##.............##............#########........##...........##.............####################.......................###...........##
##...............##.............##............#########..########...........##..####.......................####.......................###...........##
##...............##.............##................##...........##...........##....##.......................####................................###..##
#########........##.............##................##...........##...........##....##.......................####................................###..##
##...............##.............##.....##.........##...........##...........##....##.......................####.....................................##
##...............##.............##.....##.........##...........##...........##....##.......................####..................###................##
##....#############.............#########.........##...........##...........##....##.......................####.....................................##
##...............##.............##................##...........##...........##....##.......................####..............###....................##
##...............#################................##...........###############....##.......................####..........................#############
###############..###################################...........###############....##.......................####..........................#############
X............##...................................##..............#..##.....##....###########...###############.....................................##
X............##...................................##..............#..##.....##....###########...###############........####.........................##
#####........#######################....############..............#..##.....##....##.......##..............####........####.........................##
####.........##.........................##........##..............#..##...........##.......##..............####.....................................##
####.........##.........................##........##..............#..##...........##.......##..............####...............##....................##
####.........##.............####........##........##......###.....#..##...........##.......##..............####...............##.............##.....##
####..#########...............##........##........###########.....#..##...........##.......##..............####.............####.............##.....##
####.........##...............##........##........##..............##################.......##..............####..............................##.....##
####.........#########....######.......###........##..............##################.......####....############..............................##.....##
####.........##...........######....######........##..............................##.......####....################################.......#####.....##
####.........##...............##....#.............##.......................................................########################.......#####.....##
####.........##...............##..................##.......................................................####.....................................##
####.....######...............######################.......................................................####.....................................##
####..............................................#############################################################...................................####
####..............................................#############################################################...................................####
###############################################################################################################.................................######
###############################################################################################################....................................###
###############################################################################################################...........####.....................###
###############################################################################################################...........####...............####..###
###############################################################################################################..............................####..###
.........................................................................................................######............................######..###
.........................................................................................................######........##......##..................###
.........................................................................................................######.......####....####.................###
.........................................................................................................######......................#######.......###
.........................................................................................................######......................#######.......###
.........................................................................................................############..............................###
.......................................................................+-*..................+--->........############....#####.....................###
.......................................................................###..................###..........############....#####.....................###
........................................................................##..................###..........######..........###########......####.....###
...........................................................+-------*....##..................###..........######....................................###
...........................................................#########....##..................###..........######......................###...........###
...........................................................##...........##----*.............###..........######....................................###
................................................+-*........##...........#######.............###..........######....................................###
................................................###........##...........####................###-------*..######.............#######................###
................................................###........##.............##................###########..######.............#######................###
................................................###........##.............##................###..........######.............###....................###
................................................###...+----##.............##................###..........######.............###....................###
................................................###...#######.............##................###..........######.............###....................###
................................................###...#######.............##...+------*.....###..........######.......###...###....................###
................................................###...#######.............##...########.....###......+---######.............########...............###
................................................###...#######.............##................###......##########.............########...............###
................................................###...#######.............##................###......##########..###........########..#########....###
................................................###---#######-------------##................###..................###........########..#########....###
................................................############################................###........................#....########...............###
................................................###.........................................###........................#############...............###
................................................###.........................................###.............................########...............###
................................................###.........................................###.............................########...............###
................................................###.........................................###.............P...............##########################
................................................###-----------------------------------------###------------###########################################
................................................######################################################################################################
4
110
49
3
SkyUppercut
DoubleJump
Concentration 1 G
133
34
5
DoubleJump
SkyUppercut
DoubleJump
IceSummon
Concentration 3 I G S
99
14
4
DoubleJump
GlacialDrift
Concentration 2 I S
SkyUppercut
39
21
5
SkyUppercut
GlacialDrift
IceSummon
DoubleJump
Concentration 3 S I G
map13to14

