20
11
....................
....................
....................
....................
..................##
..................##
.........####.....##
##.....######...####
####################
####################
####################

