19
11
...................
...................
...................
...................
..................#
..................#
.........####.....#
##.....######...###
###################
###################
###################

