170
22
..........................................................................................................................................................................
..........................................................................................................................................................................
..........................................................................................................................................................................
..........................................................................................................................................................................
.........................................................................................................................................................................X
..................................................................................................................................................................+-------
..................................................................................................................................................................########
..........................................................................................................................................................+-------########
..........................................................................................................................................................################
..............................................................................................+-----------*...............................................################
..............................................................................................#############.................+------------*................################
.........................................................+--*......................................#####....................##############................################
.........................................................####......................................#####..........................########...........................#####
.........................................................####-----*................................#####..........................########...........................#####
....................+----*...............................##########................................#####..........................########*..........................#####
....................######...............................##########................................#####..........................#########..........................#####
.P..................######-------------------------------##########--------------------------------#####-------------*............#########..........................#####
--------------------##################################################################################################------------#########--------------------------#####
##########################################################################################################################################################################
##########################################################################################################################################################################
##########################################################################################################################################################################
##########################################################################################################################################################################
4
42
16
1
IceSummon
84
16
1
DoubleJump
102
9
1
SkyUppercut
133
10
1
Concentration 2 G D
easy
