158
20
..............................................................................................................................................................
..............................................................................................................................................................
..............................................................................................................................................................
..............................................................................................................................................................
.............................................................................................................................................................X
......................................................................................................................................................+-------
......................................................................................................................................................########
..............................................................................................................................................+-------########
..............................................................................................................................................################
..................................................................................+-----------*...............................................################
..................................................................................#############.................+------------*................################
.............................................+--*......................................#####....................##############................################
.............................................####......................................#####..........................########...........................#####
.............................................####-----*................................#####..........................########...........................#####
........+----*...............................##########................................#####..........................########*..........................#####
........######...............................##########................................#####..........................#########..........................#####
P.......######-------------------------------##########--------------------------------#####-------------*............#########..........................#####
--------##################################################################################################------------#########--------------------------#####
##############################################################################################################################################################
##############################################################################################################################################################
save
4
30
16
1
IceSummon
72
16
1
DoubleJump
90
9
1
SkyUppercut
121
10
1
Concentration 2 G D
map5to8
